2
7 11
#######
#   rr#
###R###
#     #
###R###
#     #
## #R##
#    D#
#*** D#
#    !#
#######
PLAYER 1 1
DOOR 5 7 3
DOOR 5 8 3