5
9 9
#########
#   f   #
#       #
# F   F #
#       #
#       #
#   F   #
#       #
#########
PLAYER 3 2