4
7 6
#######
#  #  #
# T#T #
#  #  #
#  # !#
#######
PLAYER 1 1
TELEPORTER 2 2 4 2