3
9 5
#########
#   #WWW#
# w  W W#
#   #WWW#
#########
PLAYER 3 2