1
7 5
#######
#     #
#     #
#    !#
#######
PLAYER 3 2