1
25 11
#########################
#!       r    *     #Tg #
###################R### #
#w# * # * #   *      #* #
# # # # # #### ##### b# #
# * # * #      #y f# ##B#
############## ##G## *# #
#!  #  Y  WWW  #        #
### ## ##################
#   D       F * *      T#
#########################
PLAYER 2 1
ENEMY 20 7 SL LEFT
TELEPORTER 21 1 23 9
DOOR 4 9 10