7 5
#######
#  #  #
#  #  #
#  # !#
#######
PLAYER 4 1
ENEMY 1 1 ST