2
25 11
#########################
#   !r      ###f   b#T#T#
# #########R##### ### # #
# #   #  g# #y  W  ## #*#
#   F #W### ### #####B# #
#*#   WW#wY      *    #*#
##############F######## #
#  *#  G  * *  #   W T#*#
# WW## #########T# #### #
#      D  !#T *### D *#T#
#########################
PLAYER 2 1
ENEMY 8 10 DT
TELEPORTER 21 1 23 9
TELEPORTER 23 1 16 8
TELEPORTER 21 7 12 9
DOOR 7 9 10