3
10 10
##########
#   #  ! #
#   #    #
#   ###  #
#   #    #
#        #
#    #   #
#   ###  #
#    #   #
##########
PLAYER 1 1