5
15 9
###############
#             #
# ### ### #b# #
# ### ##g ### #
# #r# ### ### #
#             #
############# #
#!  B   G   R #
###############
PLAYER 1 1
ENEMY 3 1 WF UP CW
ENEMY 7 1 WF UP CW
ENEMY 11 1 WF UP CW