3
10 19
##########
#        #
# ###### #
# #      #
# # ######
# #      #
# ########
#        #
######## #
#        #
# ## # ###
# ## * #!#
# ######R#
#       *#
# # # # ##
# *      #
#D######D#
#   r    #
##########
PLAYER 6 7
ENEMY 8 5 ST
DOOR 8 16 3
DOOR 1 16 3