7 5
#######
#     #
#   ! #
#     #
#######
PLAYER 3 2
ENEMY 1 1 WF DOWN ACW