5
9 6
#########
# #     #
# # # # #
# ### # #
#     # #
#########
PLAYER 3 1
ENEMY 1 1 ST