10 10
##########
#        #
#   #    #
#   #    #
#   #    #
#   #    #
#   #    #
#   #    #
#   #   !#
##########
PLAYER 1 8
ENEMY 5 8 DT