10 10
##########
#        #
#        #
#        #
#        #
#        #
#        #
#        #
#     !  #
##########
PLAYER 1 1
ENEMY 1 8 SL LEFT